20 20 1 0 19 7 1 18
********************
         c         *
*********  *********
*             *    *
*********  ******* *
* *     *  *       *
* *     *  *       *
* ****  *  ******* *
* *     *  *       *
* *     *  ******* *
* *     *  *   *   *
* *****        *   *
* *****  ****  *   *
*              *   *
***  ****   ****  **
*       *   *      *
*       *          *
*****   ************
*   *   *          *
*****   ************
