10 10 0 1 9 8 8 8
* ********
*        *
*        *
*        *
*        *
*        *
*        *
*        *
*        *
******** *
